NO   texture/NO.xpm
SO   texture/SO.xpm
WE   texture/WE.xpm
EA texture/EA.xpm

C  255, 192, 203
F  230,230,250

111111111111111111111111111111111
111100000010000000000010000000001
111100000010000000000010000000011
111100000010000000000010000000011
111100000000000000000000000000011
111111111111110111011111111111111
111100000000000000W00000000000011
111100000000000000000000000000011
111111000000001111110000000011111111111
11111100000000111111000000001111111111
111100000000000000000000000000000000011
111111000000001110110000000011111111111
11111100000000111111000000001111111
11110000000000000001000000000000011
11111100000000100001000011111111111
   11111111111111111111111
   1111111111111111111111
11100000000111111000000001111111111111
111100000000000000000000000000000000011
1111110000000011111100000000111111111111111111111
11111100000000111111000000001111111111111111111111
111100000000000000000000000000000000011
111111000000001111110000000011111111111
11111100000000111111000000001111111
1111111111111111111111111111111